20x20x10x180
Y
|-------------------|
|                 O |
|                   |
|                   |
|                   |
|                   |
|                   |
|                   |
|                   |
|                   |
|      O     P      |
|                   |
|                   |
|                   |
|                   |
|                   |
|                   |
|                   |
|                   |
|                   |
|-------------------|